000000000000000000000000000000000000000
000000000000000000000000000000000000000
000000000000000000000000000000000000000
00000000ACCACCACCACCACCACCACCACCACCA000
00000000C00000000000C00000000000000C000
00000000A00000000000A00000000000000A000
00000000C00000000000C00000000000000C000
00000000C00000000000A00000000000000A000
00000000B00000000000C00000000000000C000
00000000C00000000000A00000000000000A000
00000000C00000000000C00000000000000C000
00000000A00000000000A00000000000000A000
00000000C00000000000C00000000000000C000
00000000ACCACCACCACCACCACCACCACCACCACCA
00000000C00000000000C00000C000000000000
00000000A00000000000A00000A000000000000
00000000C00000000000C00000C000000000000
00000000A00000000000A00000A000000000000
00000000C00000000000C00000C000000000000
00000000ACCACCACCACCA00000ACCACCACCA000
00000000000000000000C00000000000000C000
00000000000000000000A00000000000000A000
00000000000000000000C00000000000000C000
00000000000000000000A00000000000000C000
00000000000000000000C00000000000000C000
00000000000000000000A00000CCCCCCCCCCCCC
00000000000000000000C00000C00000000000G
00000000000000000000A00000C00000000000C
00000000000000000000C00000C00000000000C
00000000000000000000A00000C00000000000C
00000000000000000000C00000C00000000000C
00000000000000000000A00000C00000C00000I
00000000000000000000C00000C00000C00000C
PPPPPPPPPPPPPPPPPCCCACCCCCC00000CCCCCCC
00000000000000000000C00000C00000C00000C
00000000000000000000A00000C00000C00000C
00000000000000000000C00000C000000000000
00000000000000000000A00000C000000000000
00000000000000000000C00000C000000000000
00000000000000000000A00000C000000000000
00000000000000000000C00000C000000000000
00000000000000000000A00000CCCCCCCCCCCCC
00000000000000000000C00000C000000000000
00000000000000000000A00000C000000000000
00000000000000000000C00000C000000000000
00000000000000000000A00000C000000000000
00000000000000000000C00000C000000000000
00000000ACCACCACCACCACCACCACCACCACCA000
00000000C00000000000C00000000000000C000
00000000C00000000000A00000000000000A000
00000000B00000000000C00000000000000C000
00000000C00000000000A00000000000000A000
00000000C00000000000C00000000000000C000
00000000ACCACCA00000ACCACCACCACCACCACCC
00000000000000C00000C00000C000000000000
00000000000000A00000A00000A000000000000
00000000000000C00000C00000C000000000000
00000000000000A00000A00000A000000000000
00000000000000C00000C00000C000000000000
00000000ACCACCACCACCA00000ACCACCACCA000
00000000C00000000000000000000000000C000
00000000A00000000000000000000000000A000
00000000C00000000000000000000000000C000
00000000A00000000000000000000000000A000
00000000C00000000000000000000000000C000
00000000ACCACCACCACCACCACCACCACCACCACCA
000000000000000000000000000000000000000
000000000000000000000000000000000000000
000000000000000000000000000000000000000
